000000000000000000000000000000000000000000000
011111111111111111111111111111100000000000100
011p...11111111111111110001111111111111110100
011111.01111111111111111110111111001111110100
011111.10000000001111111110111111001111110100
01111.......m11101111111110111111001111110100
011111110111111110111111110111111001111110100
011111110111111110111111110111111001111110100
011111111000000000111111110111110011111110100
011111111111111100001111111111111111111011110
011111111110000000110000111111111101111011110
011111111111111111111110011111111011111011110
011111111111111111111111011111110011111011110
011111111111111111111111011111100111111011110
011111111111111111111111011111100111111011110
011111111111111111111111011111001111111011110
011111111111111111111111011111000000000011000
011110000000000111111111111000111111111111110
011111111111111000111111111100000111000001110
011111111111111110000010111111101111001101110
011111111111111111111100001110001111101111110
011111111111111111011111100111000111101111110
011111111111111111111111111111100111111111110
000000000000000000000000000000000000000000000
